1,1,1,1,1,1,1,1,1,1,1,1,1,1,1,1,1,1,1,1,1
1,0,0,0,0,0,0,6,0,0,0,0,0,0,0,0,0,0,0,0,0
1,0,0,0,0,0,1,1,1,0,0,0,0,0,0,0,0,0,0,0,0
1,2,0,0,0,0,0,0,0,0,0,0,0,0,0,0,0,0,0,0,0
1,0,0,1,1,1,0,0,0,0,0,0,0,0,0,0,0,0,0,0,0
1,0,0,0,0,0,0,0,0,0,0,0,0,0,0,0,0,0,1,0,1
1,1,0,0,0,0,0,0,0,0,0,0,0,0,0,0,0,0,0,0,1
1,1,1,0,0,0,0,0,0,0,0,3,0,0,0,0,1,0,0,0,1
1,1,1,1,0,0,0,0,0,1,1,1,1,0,0,0,0,0,0,0,1
1,1,1,1,1,0,0,0,0,0,0,0,0,0,1,5,5,0,0,0,1
1,1,1,1,1,4,1,1,0,0,0,0,0,0,1,1,1,0,6,0,1
0,0,0,0,1,0,1,1,0,0,0,0,0,0,1,0,1,5,5,5,1
-1,-1,-1,-1,1,-1,1,1,3,3,3,3,3,3,1,-1,1,1,1,1,1
